1100 1000 1001 1100 1001 1100 1000 1001
0100 0000 0011 0110 0011 0110 0010 0011
0100 0001 1100 1000 1000 1001 1100 1001
0110 0011 0110 0010 0010 0011 0110 0011
1100 1000 1000 1000 1001 1100 1001 1101
0110 0010 0010 0010 0011 0110 0011 0111
2 4 v
5 1 f
5 8 v
2 2
2 3
3 2
3 3 
3 4
3 5
4 4
5 6
5 7
6 6
1 3 1 4
2 5 2 6
2 8 3 8
3 2 3 3 
4 4 5 4
4 6 4 7
6 5 6 6
6 7 6 8
1 6
3 1
4 8
6 3
(arriba, izquierda, abajo, derecha)